...###.....
..##.#.###.
.##..###...
##.........
#..#@#.#...
########...
..#..#.....
.##.##.#.#.
.#......##.
.#.....##..
...........