####...####
#.........#
#.........#
...........
....@#.#...
...........
#....#....#
#.........#
#.........#
#.........#
####...####
