................................................................
................................................................
................................................................
................................................................
................................................................
................................................................
................................................................
................................................................
................................................................
................................................................
................................................................
................................................................
................................................................
................................................................
................................................................
................................................................
................................................................
.......................................!!.................!!!...
!...................................!!!##!!!.......!!!...######.
#!.................................!############################
##!...............................!###############..............
###!...........................!!!#############.................
####!..@....................!!!##############...................
#####!!!!!!!!!!!!!!!!!!!!!!!####################################