................................................................
...............................................................!
..............................................................!#
.............................................................!##
............................................................!###
...........................................................!####
..........................................................!#####
.........................................................!######
........................................................!#######
.......................................................!########
......................................................!#########
.....................................................!##########
....................................................!###########
...................................................!############
..................................................!#############
.................................................!##############
................................................!###############
...............................................!################
..............................................!#################
.............................................!##################
............................................!###################
.........@.................................!####################
!!!!!!!!!!!!!!!!!!!!!.....................!#####################
################################################################