................................................................
................................................................
................................................................
................................................................
................................................................
................................................................
................................................................
................................................................
................................................................
................................................................
................................................................
................................................................
.......................!!.......................................
......................!##!......................................
.....................!####!!....................................
....................!#######!...................................
...................!#########!!!................................
..................!#############!!..............................
.................!################!!............................
................!###################!!..........................
...............!######################!!........................
..............!#########################!!!.....................
!..@.........!#############################!!!!................!
################################################################