................................................................
................................................................
................................................................
................................................................
................................................................
................................................................
................................................................
................................................................
................................................................
................................................................
................................................................
................................................................
................................................................
................................................................
................................................................
................................................................
...............................!!!..............................
..............................!##########.......................
..............................#############!!!!.................
............................###################!!...............
!.......................!#############..........................
#!....................!############.............................
##!........@.......!!!####################......................
###!!!!!!!!!!!!!!!!#######################!!!!!!!!!!!!!!!!!!!!!!