................................
................................
................................
................................
................................
................................
................................
................................
................................
................................
................................
................................
................................
................................
................................
................................
...............................!
..............................!#
..............................##
............................####
!.......................!#######
#!....................!#########
##!........@.......!!!##########
###!!!!!!!!!!!!!!!!#############