................................
................................
................................
................................
................................
................................
................................
................................
................................
................................
................................
................................
................................
................................
................................
................................
...............................!
..............................!#
..............................##
............................####
........................!#######
......................!#########
...................!!!##########
!!!!!!!!!!!!!!!!!!!#############