................................
................................
................................
................................
................................
................................
................................
................................
................................
................................
................................
................................
................................
................................
................................
................................
...............................!
..............................!#
..............................##
............................####
........................!#######
......................!#########
...@...............!!!##########
!!!!!!!!!!!!!!!!!!!#############